1111111011
1010101010
1011000011
1111011011
1011000011
0010101001
1011111011
1111111011
1000000001
1011111111
1111111111
